%%%%%%%%%%%%%%%%%%%%%%%%%
%%....%%%.......%%......%
%..%%..%%%%%%..%%%.%%%%.%
%%%%..%%%%%%..%%%%.%%%%.%
%%%..%%%%%%..  P  .%%%%.%
%...%%%%%%..%%%%%%.%%%%.%
%......  ..%%%%%%%......%
%%%%%%%%%%%%%%%%%%%%%%%%%
