%%%%%%%%%%%%%%%%%%%%%
%...%%%...%%%%.%.%%%%
%.%.....%......%....%
%.%%%.%%%%%.%%%%%%%.%
%.....%........P....%
%%%%%%%%%%%%%%%%%%%%%
